wwwwwwwwwwwwwwwwwww
w   b b b b b b b w
w w w w w w w w w w
w b b b b b b b b w
wbw  b   w   b  w w
w b     www     b w
wbw   b w w b   w w
w b     www     b w
wbw  b       b  w w
w wbw b bwb b wbw w
wb b b b b b b b bw
wwwwwwwwwwwwwwwwwww