wwwwwwwwwwwwwwwwwwww
w-----b-b-b-b-b-b--w
w-w-w-w-w-w-w-w-wbww
w-b-b-b-b-b-b-b-b--w
wb---b-------b--wbww
w-b-------------b--w
wb----b-----b---w-ww
w-b-------------b--w
wbw--b-------b--w-ww
w-wbw-b-bwb-b-wbw--w
wb-b-b-b-b-b-b-b-b-w
wwwwwwwwwwwwwwwwwwww
18 1
15 1
15 8
9 6
1 9
5 5
7 1
17 7
13 3