wwwwwwwwwwwwwwwwwwww
w-----b-b-b-b-b-b-bw
w-w-w-w-w-w-w-w-w-bw
w-b-b-b-b-b-b-b-b-bw
wb---b-------b--w-bw
w-b-------------b-bw
wb----b-----b---w-bw
w-b-------------b-bw
wbw--b-------b--w-bw
w-wbw-b-bwb-b-wbw-bw
wb-b-b-b-b-b-b-b-bbw
wwwwwwwwwwwwwwwwwwww